ubiquitous  - povsemestno
well-versed - хорошо разбирающегося
reveal - раскрывать
insight - понимание, проницательность
ultimately - в конечном счете
precipitation - атмосферные осадки
congested - перегружен
sophisticated  - complex 
evade - уклоняться
clause - пункт, оговорка
threshold - порог
arbitrary - произвольный, случайный
slope - склон
prowess - доблесть
tenured - постоянный
suffice - Достаточно ( from sufficient ) 
thriving  - процветающий
weave  - ткать, плести , create 
narrative - повествование, рассказ
controversy - спор, полемика, дискуссия, ссора
hunch - догадываться
ambiguity - двусмысленность
diminish - уменьшать
expunge - вычищать
inadvertent - непреднамеренный
parse-  разбирать
intricacies  - tonkosti 
pervasive - rasprostranayushiysya
deploy - развертывать
persist - сопротивляться, сохраняться, упорствовать
complementary - additional 
unsolicited -  незапрошенный
cluster- Grouping unlabeled examples is called clustering
fraudulent - мошеннический 
maze - labirint 
loosely emulate  - слабо подражать
customizable - настраиваемый
repository  - хранилище
invoke - вызывать
spanning - охватывающий